#######################################
# Syntax Coloring Map
#######################################
#######################################
# # Datatypes (KEYWORD1)
#######################################
FlprogDNSClient	KEYWORD1
FlprogDhcpClass	KEYWORD1
FlprogDhcpClass;	KEYWORD1
FlprogEthernetClass	KEYWORD1
FlprogEthernetClient	KEYWORD1
FlprogEthernetClient;	KEYWORD1
FlprogEthernetServer	KEYWORD1
FlprogEthernetServer;	KEYWORD1
FlprogEthernetUDP	KEYWORD1
FlprogEthernetUDP;	KEYWORD1
FlprogIPPROTO	KEYWORD1
FlprogSnIR	KEYWORD1
FlprogSnMR	KEYWORD1
FlprogSnSR	KEYWORD1
FlprogW5100Class	KEYWORD1

#######################################
# Methods and Functions (KEYWORD2)
#######################################
MACAddress	KEYWORD2
RBASE	KEYWORD2
SBASE	KEYWORD2
accept	KEYWORD2
available	KEYWORD2
availableForWrite	KEYWORD2
begin	KEYWORD2
beginMulticast	KEYWORD2
beginPacket	KEYWORD2
beginWithDHCP	KEYWORD2
bool	KEYWORD2
checkLease	KEYWORD2
connect	KEYWORD2
connected	KEYWORD2
dnsServerIP	KEYWORD2
endPacket	KEYWORD2
execCmdSn	KEYWORD2
flush	KEYWORD2
gatewayIP	KEYWORD2
getChip	KEYWORD2
getDhcpServerIp	KEYWORD2
getDnsServerIp	KEYWORD2
getGatewayIp	KEYWORD2
getHostByName	KEYWORD2
getIPAddress	KEYWORD2
getLinkStatus	KEYWORD2
getLocalIp	KEYWORD2
getMACAddress	KEYWORD2
getSocketNumber	KEYWORD2
getSubnetMask	KEYWORD2
hardwareStatus	KEYWORD2
hasOffsetAddressMapping	KEYWORD2
inet_aton	KEYWORD2
init	KEYWORD2
linkStatus	KEYWORD2
localIP	KEYWORD2
localPort	KEYWORD2
maintain	KEYWORD2
operator!=	KEYWORD2
operator==	KEYWORD2
parsePacket	KEYWORD2
peek	KEYWORD2
read	KEYWORD2
read##name	KEYWORD2
remoteIP	KEYWORD2
remotePort	KEYWORD2
setConnectionTimeout	KEYWORD2
setDnsServerIP	KEYWORD2
setGatewayIP	KEYWORD2
setGatewayIp	KEYWORD2
setIPAddress	KEYWORD2
setLocalIP	KEYWORD2
setMACAddress	KEYWORD2
setRetransmissionCount	KEYWORD2
setRetransmissionTime	KEYWORD2
setRetransmissionTimeout	KEYWORD2
setSS	KEYWORD2
setSubnetMask	KEYWORD2
status	KEYWORD2
statusreport	KEYWORD2
stop	KEYWORD2
subnetMask	KEYWORD2
write	KEYWORD2
write##name	KEYWORD2

#######################################
# Constants (LITERAL1)
#######################################
#define	FLPROG_DHCP_ACK		5	LITERAL1
#define	FLPROG_DHCP_DECLINE		4	LITERAL1
#define	FLPROG_DHCP_DISCOVER		1	LITERAL1
#define	FLPROG_DHCP_RELEASE		7	LITERAL1
#define	FLPROG_DHCP_REQUEST		3	LITERAL1
#define	FLPROG_STATE_DHCP_DISCOVER	1	LITERAL1
#define	FLPROG_STATE_DHCP_LEASED	3	LITERAL1
#define	FLPROG_STATE_DHCP_RELEASE	5	LITERAL1
#define	FLPROG_STATE_DHCP_REQUEST	2	LITERAL1
#define	FLPROG_STATE_DHCP_REREQUEST	4	LITERAL1
FLPROG_DEFAULT_LEASE	(900)	LITERAL1
FLPROG_DHCP_BOOTREPLY		2	LITERAL1
FLPROG_DHCP_BOOTREQUEST	1	LITERAL1
FLPROG_DHCP_CHECK_NONE	LITERAL1
FLPROG_DHCP_CHECK_REBIND_FAIL	LITERAL1
FLPROG_DHCP_CHECK_REBIND_OK	LITERAL1
FLPROG_DHCP_CHECK_RENEW_FAIL	LITERAL1
FLPROG_DHCP_CHECK_RENEW_OK	LITERAL1
FLPROG_DHCP_CLIENT_PORT	68	/*	LITERAL1
FLPROG_DHCP_FLAGSBROADCAST	0x8000	LITERAL1
FLPROG_DHCP_HLENETHERNET	6	LITERAL1
FLPROG_DHCP_HOPS		0	LITERAL1
FLPROG_DHCP_HTYPE100MB		2	LITERAL1
FLPROG_DHCP_HTYPE10MB		1	LITERAL1
FLPROG_DHCP_INFORM		8	LITERAL1
FLPROG_DHCP_NAK		6	LITERAL1
FLPROG_DHCP_OFFER		2	LITERAL1
FLPROG_DHCP_SECS		0	LITERAL1
FLPROG_GAR	LITERAL1
FLPROG_HOST_NAME	LITERAL1
FLPROG_MAGIC_COOKIE		0x63825363	LITERAL1
FLPROG_MAX_DHCP_OPT		16	LITERAL1
FLPROG_MR	LITERAL1
FLPROG_PHYCFGR_W5500	LITERAL1
FLPROG_PSTATUS_W5200	LITERAL1
FLPROG_RCR	LITERAL1
FLPROG_RMSR	LITERAL1
FLPROG_RTR	LITERAL1
FLPROG_SHAR	LITERAL1
FLPROG_SIPR	LITERAL1
FLPROG_SN_CR	LITERAL1
FLPROG_SN_RX_SIZE	LITERAL1
FLPROG_SN_TX_SIZE	LITERAL1
FLPROG_STATE_DHCP_START	0	LITERAL1
FLPROG_SUBR	LITERAL1
FLPROG_TMSR	LITERAL1
FLPROG_UDP_TX_PACKET_MAX_SIZE	LITERAL1
FLPROG_VERSIONR_W5200	LITERAL1
FLPROG_VERSIONR_W5500	LITERAL1
FLPROG_W5100_H_INCLUDED	LITERAL1
FLPROG_W5100_UTIL_H	LITERAL1
FlprogDNSClient_h	LITERAL1
FlprogDhcp_h	LITERAL1
MAX_SOCK_NUM	LITERAL1
SPI_ETHERNET_SETTINGS	LITERAL1
__GP_REGISTER16(name,	LITERAL1
__GP_REGISTER8(name,	LITERAL1
__GP_REGISTER_N(name,	LITERAL1
__SOCKET_REGISTER16(name,	LITERAL1
__SOCKET_REGISTER8(name,	LITERAL1
__SOCKET_REGISTER_N(name,	LITERAL1
flporgW5100Ntohl(x)	LITERAL1
flporg_ethernet_h_	LITERAL1
flprogW5100Htonl(x)	LITERAL1
flprogW5100Htons(x)	LITERAL1
flprogW5100Ntohs(x)	LITERAL1
from	LITERAL1